  # # # # # # # # # # #
          #           #
# # # #   # # #   #   #
#             #   #   #
#   # # #     #   #   #
#   #   # # # #   #   #
#   #             #   #
#   #   # #   #   #   #
#         #       #   #
# # # # # # # # # #   S